Laps,Climb,Area,Difficulty,"Leisure Laps","Guiding Laps"
25,"Totem (p1 only)","Seneca Rocks",5.4,5,20
21,"Old Man's Route","Seneca Rocks",5.2,11,10
15,"Devil in the White House","Pilot Mountain",5.10c,15,0
13,"Skyline Traverse","Seneca Rocks",5.3,9,4
13,"The Medallion","Teer Quarry",5.10a,13,0
11,Predator,"Seneca Rocks",5.12a,11,0
10,"Conn's West","Seneca Rocks",5.4,3,7
9,"Gunsight to South Peak","Seneca Rocks",5.4,6,3
9,"Old Ladies Route","Seneca Rocks",5.2,6,3
9,"The Great Arch","Stone Mountain",5.5,8,1
8,"Worrell's Thicket","Seneca Rocks",5.1,5,3
8,"Roy Gap Chimney's","Seneca Rocks",5.6,2,6
8,"Ecstasy Junior","Seneca Rocks",5.4,5,3
8,"New Yosemite","The Junkyard",5.9,8,0
8,Erocktica,"Pilot Mountain",5.10c,8,0
7,Crescendo,"Nelson Rocks",5.10a,7,0
7,"Candy Corner","Seneca Rocks",5.6,2,5
6,"The Burn","Seneca Rocks",5.8,3,3
6,"Any Major Dude","Pilot Mountain",5.11c,6,0
5,"Critter Crack","Seneca Rocks",5.6,3,2
5,Thais,"Seneca Rocks",5.6,2,3
5,Ambush,"Seneca Rocks",5.11a,3,2
5,"Grandpa's Belay","Pilot Mountain",5.6,5,0
5,"U Slot","Stone Mountain","5.7, PG13",4,1
5,"Sentinel Buttress","Sentinel Buttress",5.5,5,0
5,"Pole Dancing","Pilot Mountain",5.7,5,0
4,"Porcelain Pump","Nelson Rocks",5.11a,4,0
4,Mongoose,"Seneca Rocks",5.11a,4,0
4,Lifers,"Nelson Rocks",5.10a,4,0
4,Dominion,"Nelson Rocks",5.10b,4,0
4,"West Pole","Seneca Rocks",5.7,3,1
4,"Man Overboard","Pilot Mountain",5.10c,4,0
4,Costao,"Pao de Acucar",5.7,3,1
4,"Bee Sting Corner","Seneca Rocks",5.7,3,1
4,"Le Gourmet","Seneca Rocks",5.4,2,2
4,"Neck Press","Seneca Rocks",5.7,2,2
4,Prune,"Seneca Rocks",5.7,3,1
4,Narcissus,"Narcissus Cave",5.12a,4,0
4,"Thais - Variation Thais Escape","Seneca Rocks",5.5,0,4
4,"Ye Gods & Little Fishes","Seneca Rocks",5.8,2,2
4,"Triple S","Seneca Rocks",5.8,2,2
4,Outhouse,"Pilot Mountain",5.7,4,0
4,"Crackin' Up","Pilot Mountain",5.7,4,0
4,"Son of White Trash","The Dump",5.8,4,0
4,"Pilot Error (chicken bone right)","Pilot Mountain",5.8-,4,0
4,Vegomatic,"Pilot Mountain",5.7+,4,0
4,Hardman,"Rocky Face",5.11b,4,0
4,"NE end flows","Doughton Park",WI3-,4,0
4,"The Herculean Test","Pilot Mountain",5.10d,4,0
4,"Henar Lite","Pilot Mountain",5.10c,4,0
4,"Smooth Sailing (aka Lloyd Would Have Liked It)","Pilot Mountain",5.10a,4,0
3,"West Face","Leaning Tower","5.7, C3, Grade V",3,0
3,"Frosted Flake","Cereal Buttress",5.9+,3,0
3,"Marshall's Madness","Seneca Rocks",5.9,2,1
3,"Grizzly Adams","Nelson Rocks",5.11a,3,0
3,Coringa,"Pao de Acucar",5.6,2,1
3,"Front C","Seneca Rocks",5.6,1,2
3,"Lower Skyline Direct (LSD)","Seneca Rocks",5.5,2,1
3,"License to Drill","Nelson Rocks",5.10a,3,0
3,Pollux,"Seneca Rocks",5.10a,3,0
3,"Right Tope","Seneca Rocks",5.9,3,0
3,"Block Party","Seneca Rocks",5.8,1,2
3,Sunshine,"Seneca Rocks","5.10a, PG13",3,0
3,Ecstasy,"Seneca Rocks",5.7,3,0
3,"High Test","Seneca Rocks",5.9,3,0
3,"Hot Yoga","Pilot Mountain",5.10a,3,0
3,KMA,"Pilot Mountain",5.8,3,0
3,"Unwritten Law","The Dump",5.12b,3,0
3,"Dimpsty Dumpster","The Dump",5.10a,3,0
3,"Voodoo Child","The Dump",5.11a,3,0
3,"Fear of Flying","Seneca Rocks",5.8,1,2
3,"Quaker State","Moores Amphitheater",5.11a,3,0
3,"Head Jam","Moores Central Wall",5.6,3,0
3,"Chicken Bone","Pilot Mountain",5.8,3,0
3,"Daughton Line","Doughton Park",WI3,3,0
3,"Black Hole","Rocky Face",5.10d,3,0
3,"Sunny Day","Rocky Face",5.8,3,0
3,"Pillar Assault","Pilot Mountain",5.8,3,0
3,"Overhang Hangover","Pilot Mountain",5.11b,3,0
3,"True Grits","Pilot Mountain",5.8+,3,0
3,"Walk the Plank","Pilot Mountain",5.8,3,0
3,"Team Jesus","The Junkyard",5.10a,3,0
3,"New River Gunks","The Junkyard",5.7+,3,0
3,"Fruit Loops","Cereal Buttress",5.7+,3,0
3,"The Entertainer","The Junkyard",5.10a,3,0
3,"Teflon Toes","Pilot Mountain",5.11a,3,0
3,"Tee Ball","The Trestle",5.6,3,0
2,"The Glass Menagerie (Aid)","Looking Glass Rock","5.10a, C2, PG13, Grade IV",2,0
2,"Blue Glacier","Mount Olympus","Moderate Snow, 5th, Grade II",2,0
2,"Bat Girl","Sasquatch Crag",5.9,2,0
2,"Master Gardner","Cotton Club",5.7-,2,0
2,Starry,"Upper Meadow",5.12a,2,0
2,"Mr. Cute","Upper Meadow",5.11a,2,0
2,Kakaroots,Cantagalo,5.9,2,0
2,"Inversao Feminina",Graalzinho,5.7,2,0
2,"Formiga Atomica",Graalzinho,5.6,2,0
2,Graalzinho,Graalzinho,5.5,2,0
2,K2,Corcovado,"5.9, PG13",2,0
2,"Via dos Italianos","Pao de Acucar","5.10a, Grade III",2,0
2,"Dufty's Popoff","Seneca Rocks","5.7, PG13",2,0
2,"Gert's Grungy Gulley","Seneca Rocks",5.4,0,2
2,"Gunsight to South Peak Direct","Seneca Rocks",5.4,1,1
2,Millennium,"Nelson Rocks",5.7,2,0
2,"Green Wall","Seneca Rocks",5.7,1,1
2,Mushrooms,"Beauty Mountain",5.10a,2,0
2,"Back to the Front","Seneca Rocks",5.9,2,0
2,"Seneca Daze","Seneca Rocks","5.7, PG13",1,1
2,"Never Say Never","Nelson Rocks",5.10c,2,0
2,"Internal Dialogue","Reeds Creek",5.8,2,0
2,"Honey Hole 5.7","Honey Hole",5.7,2,0
2,"Honey Hole 5.10a","Honey Hole",5.10a,2,0
2,"Pleasant Overhangs","Seneca Rocks",5.7,2,0
2,"Climbin' Punishment","Seneca Rocks",5.8,2,0
2,"Conn's East","Seneca Rocks",5.6,2,0
2,Kauffman-Cardon,"Seneca Rocks",5.4,1,1
2,T&T,"Seneca Rocks",5.8,2,0
2,"Up and Coming","Seneca Rocks",5.4,1,1
2,"Sea of Tranquility","Reeds Creek",5.10a,2,0
2,"Breakneck Direct","Seneca Rocks",5.10b,2,0
2,Oz,"Nelson Rocks",5.7,2,0
2,"Humphrey's Head","Seneca Rocks",5.4,2,0
2,Abandoned,"Nelson Rocks",5.7,2,0
2,"Southwest Buttress Variation","Seneca Rocks",5.5,2,0
2,"Random 5.6","Petes Rock",5.6,2,0
2,"Blind Prophet","Pilot Mountain","5.12b, PG13",2,0
2,Springboard,"Fern Buttress",5.10b,2,0
2,"Animal Logic","DC Memorial Boulder",5.12b,2,0
2,"Dude on the Corner","Pilot Mountain",5.9,2,0
2,"Easy Hard","Moores Central Wall",5.5,1,1
2,"The 8th Sin","The Underworld",5.11d,2,0
2,"Short Shagg","Shagg Crag",5.9,2,0
2,"Dirty Harry","Camden Hills",5.11a,2,0
2,"500 Pound Flakeout","Camden Hills",5.7,2,0
2,"Wonder Wall","Otter Cliffs",5.8,2,0
2,Castor,"Seneca Rocks",5.10a,2,0
2,Soler,"Seneca Rocks",5.7,2,0
2,"Fat Boy","Pilot Mountain",5.11a,2,0
2,"Thin to Win","Pilot Mountain",5.10b,2,0
2,"Almost Seven (aka Golden Earring)","Moores Amphitheater",5.7,2,0
2,"Bedtime for Bonzo","Fortress Wall",5.6,2,0
2,"Entrance Crack","Stone Mountain","5.5, R",2,0
2,"Kish Dish",Sauratown,5.8,2,0
2,Novi,"Pilot Mountain",5.7+,2,0
2,"Left Of Time","Rocky Face",5.7,2,0
2,Bullistics,"Rocky Face",5.10b,2,0
2,"Hidden-mite short","Rocky Face",5.9+,2,0
2,"Mr. Henar","Pilot Mountain","5.12a, PG13",2,0
2,"When Shrimp Learn to Whistle","Pilot Mountain",5.11b,2,0
2,Deceivious,"The Cookbook",5.1,2,0
2,"Flight Time","Rocky Face",5.7+,2,0
2,"Barbs World",Sauratown,5.10b,2,0
2,Quickdraw,"Rocky Face",5.11b,2,0
2,"Blast in Black","Rocky Face",5.9+,2,0
2,"Anguish of Captain Bligh","Ship Rock",5.11a,2,0
2,"Block Route","Stone Mountain","5.7+, PG13",2,0
2,"Burning Calves","Beauty Mountain",5.10b,2,0
2,"Out of Mind","Beauty Mountain",5.10a,2,0
2,"Happy Hands","Beauty Mountain",5.9,2,0
2,"Hippie Dreams","Orange Oswald Wall",5.7+,2,0
2,"The Rico Suave Arete aka Rico Suave","Rico Suave Buttress",5.10a,2,0
2,Yowsah,Kaymoor,5.12b,2,0
2,Casablanca,"Pilot Mountain",5.10a,2,0
2,"Too Old to Rock and Roll","Pilot Mountain",5.10c,2,0
2,"Wailing Wall","Moores Amphitheater",5.6,2,0
2,"Zoo View","Circus Wall",5.7+,2,0
2,Butterfingers,"Pilot Mountain",5.11a,2,0
2,Jammerfest,Djupfjorden,5.10b,2,0
2,Gandalf,"Gandalf Wall",5.8,2,0
2,"Litten Oppdrift",Natten,5.11a,2,0
2,"Whiskey Sour",Sauratown,5.6,2,0
2,"Another Alternative","Pilot Mountain",5.8,2,0
2,"To Tee or Not To Tee","The Trestle",5.10a,2,0
2,"Climbing Merit Badge","Sand Rock",5.6,2,0
2,Psycho-metric,"Pilot Mountain",5.11a,2,0
2,"No Alternative","Stone Mountain","5.5, PG13",2,0
2,"The Black Hole","Pilot Mountain",5.10b,2,0
2,Ironman,"Pilot Mountain",5.8+,2,0
2,Crackerjack,"Table Rock",5.8,2,0
2,"Sniff the Drill","Narcissus Cave",5.8,2,0
2,"She Got the Bosch, I Got Drilled","Orange Oswald Wall",5.10a,2,0
2,"Chunko Goes Bowling","Orange Oswald Wall",5.9+,2,0
2,Granola,"Cereal Buttress",5.8+,2,0
2,"East Of Eden","Grayson Highlands",V0-,2,0
2,"Magnetic North","Grayson Highlands",V0-,2,0
2,"Peace of Westphalia (PoW)","Grayson Highlands",V0,2,0
2,"Windy Heights","Grayson Highlands",V0-,2,0
2,"Highland Highball","Grayson Highlands",V1-,2,0
2,Slabacious,"Grayson Highlands",V0,2,0
2,"Huecool Junior","Tieranny Roofs",5.10c,2,0
2,"Reaching New Heights","The Junkyard",5.11b,2,0
2,"Bubba Safari","Bubba City","5.8, PG13",2,0
2,"Iced Tee","The Trestle",5.8+,2,0
2,"Papa Bear","Pilot Mountain",5.10b,2,0
2,"Black Rain","Pilot Mountain",5.9,2,0
2,"Baby Bear","Pilot Mountain",5.11a,2,0
2,"Spock's Brain","Seneca Rocks",5.11a,2,0
2,"Mild Mannered Secretary","Pilot Mountain",5.7,2,0
1,Commitment,"Five Open Books",5.9,1,0
1,"Separate Reality","Wildcat Falls",5.12a,1,0
1,"Regular Route","Sunnyside Bench",5.5,1,0
1,Butterballs,"Cookie Cliff",5.11c,1,0
1,"Beverly's Tower","Cookie Cliff",5.10a,1,0
1,Freeblast,"El Capitan","5.9, C2, Grade IV",1,0
1,Tuscarora,"Champe Rocks",5.7,1,0
1,SPF40,"The Beach",5.9,1,0
1,"Janoscrat Crack","Champe Rocks",5.11a,1,0
1,"Behind the Pine","Champe Rocks",5.10a,1,0
1,"Kissler-Clark Route","Champe Rocks",5.10d,1,0
1,"Shitty Sequel","Nelson Rocks","5.5, PG13",1,0
1,"The Lost World","Nelson Rocks",5.10c,1,0
1,"Tommy T","Nelson Rocks",5.6,1,0
1,"Notch Up Another One","Nelson Rocks",5.11a,1,0
1,"Lusting for Ladybugs","Entrance Wall",5.11a,1,0
1,"Ugly Duckling","Entrance Wall",5.7,1,0
1,"Leaky Corner","Sasquatch Crag",5.6,1,0
1,Superstition,"Seneca Rocks",C2,1,0
1,Skywalker,"Reeds Creek",5.12a,1,0
1,"Still Laughing","Reeds Creek",5.10b,1,0
1,"La Machina","Reeds Creek",5.11b,1,0
1,Joker,"Reeds Creek",5.10a,1,0
1,"Grain of Sand","Reeds Creek",5.10c,1,0
1,Superwoman,"Reeds Creek",5.8+,1,0
1,"The Tribe Lite","Nelson Rocks",5.10a,1,0
1,Moderato,"Nelson Rocks",5.5,1,0
1,"Sixth Sense","Seneca Rocks",C2,1,0
1,"Riverton South Orange Buttress","Riverton Rock",5.10a,1,0
1,"Riverton South Mixed Line (porchview)","Riverton Rock",5.9,1,0
1,"Ventilator Shaft","Cotton Club",5.7-,1,0
1,"Ben Dunne","Upper Meadow",5.10a,1,0
1,"The Wanderer","Upper Meadow",5.10a,1,0
1,"North Ridge","Table Rock",5.5,1,0
1,Jaws,"Grayson Highlands",V0-,1,0
1,"The Prow","Linville Amphitheater",5.4,1,0
1,Birdland,"The Near Trapps",5.8+,1,0
1,"The Threat","Seneca Rocks",5.12b,1,0
1,"Unknown 5.10c","Nelson Rocks",5.10c,1,0
1,"The Petting Zoo","Nelson Rocks",5.10b,1,0
1,"The Wax Museum","Nelson Rocks",5.10a,1,0
1,"Ed's Fudge Shop","Nelson Rocks",5.10a,1,0
1,"Cast of Thousands","Nelson Rocks",5.10a,1,0
1,Silhouette,"Pilot Mountain",5.9,1,0
1,"Ovos Na Chapa","Morro Dona Marta",5.9,1,0
1,"Fissura Esquecida","Morro Dona Marta",5.10a,1,0
1,"Passagem dos Olhos","Pedra da Gavea","5.8, Grade IV",1,0
1,"Via do Crico",Graalzinho,5.8,1,0
1,Rapunzel,Graalzinho,5.9,1,0
1,"Para os Baixinhos",Graalzinho,5.9,1,0
1,Infravermelho,"Morro da Urca",5.6,1,0
1,CERJ,Capacete,"5.9, PG13, Grade III",1,0
1,K3,Corcovado,5.10d,1,0
1,"Waldemar Guimaraes (Waldo)","Pao de Acucar","5.11d, PG13, Grade III",1,0
1,CEPI,"Pao de Acucar",B,1,0
1,"Preto (with Rubro Negro var)","Morro da Urca",5.7,1,0
1,Agony,"Seneca Rocks",5.10b,1,0
1,"Stone Gallows","Nelson Rocks",5.10b,1,0
1,"Windy Corner","Seneca Rocks",5.4,1,0
1,Totem,"Seneca Rocks",5.11a,1,0
1,"La Bella Vista","Seneca Rocks",5.10a,1,0
1,"Traffic Jam","Seneca Rocks",5.7,1,0
1,"Gunsight To North Peak","Seneca Rocks",5.1,1,0
1,Sirius,"Nelson Rocks",5.10a,1,0
1,"Screamer Crack","Beauty Mountain",5.8,1,0
1,"The Decameron","Bubba City",5.10b,1,0
1,Kinesthetica,"Bubba City",5.10c,1,0
1,"Mrs. Field's Follies","Bubba City",5.8,1,0
1,"Geisha Girl","Bubba City",5.8,1,0
1,"Satisfaction Guaranteed","Satisfaction Wall",5.11a,1,0
1,"Lickety Split","Satisfaction Wall",5.9,1,0
1,34D,"Nelson Rocks",5.10b,1,0
1,"Rox Salt","Seneca Rocks",5.6,1,0
1,"Rear Entry","Seneca Rocks",5.8,1,0
1,"Flying Bunghole","Nelson Rocks",5.10b,1,0
1,"Wild Men Only","Seneca Rocks","5.10a, PG13",1,0
1,Kamikaze,"Nelson Rocks",5.10a,1,0
1,"Honey Hole 5.8","Honey Hole",5.8,1,0
1,"EZ Wider","Nelson Rocks",5.6,1,0
1,Orangeaid,"Seneca Rocks",5.10b,1,0
1,"Two Scoops","Nelson Rocks",5.11d,1,0
1,IMOL,"Nelson Rocks",5.10a,1,0
1,"Two Poops","Nelson Rocks",5.10b,1,0
1,"Bear's Delight","Seneca Rocks",5.6,1,0
1,"Lichen or Leave It","Seneca Rocks",5.8,1,0
1,"Judgement Seat","Seneca Rocks",5.10a,1,0
1,"Cottonmouth - Venom","Seneca Rocks",5.10a,1,0
1,"Dr Taco","Reeds Creek",5.7,1,0
1,"Welcome to Reed's Creek","Reeds Creek",5.7,1,0
1,"Catfish Strangler","Reeds Creek",5.11a,1,0
1,Shorty,"Nelson Rocks",5.11b,1,0
1,Daytripper,"Seneca Rocks",5.10a,1,0
1,"Bottom Feeder","Nelson Rocks",5.8,1,0
1,"Put A Wiggle In Your Stride","Seneca Rocks",5.12a,1,0
1,S&M,"Seneca Rocks",5.8,1,0
1,"Dirty Old Man","Seneca Rocks",5.6,1,0
1,"Frosted Flake","Seneca Rocks",5.9,1,0
1,Nameless,"Nelson Rocks",5.8,1,0
1,"Crispy Critter","Seneca Rocks",5.7,1,0
1,"Le Gourmet Direct","Seneca Rocks",5.7,1,0
1,"North Ridge","Garden of the Gods",5.7,1,0
1,"Random Couloir","Chasm Lake","AI2, PG13",1,0
1,"Vitamin V","Surprising Crag",5.9,1,0
1,"Chasing Sticks","Surprising Crag",5.9,1,0
1,Vertigo,"Redgarden Wall",5.11b,1,0
1,"Full Recovery","Thatchtop Mt",WI2-,1,0
1,"Kool Cat","Cat Wall",5.11a,1,0
1,"To Skin a Cat","Cat Wall",5.12a,1,0
1,"More Than One Way","Cat Wall",5.10d,1,0
1,Catsup,"Cat Wall",5.10a,1,0
1,"Trip to the Vet","Cat Wall",5.10d,1,0
1,"Standard Route","The Pickle",C0,1,0
1,"West Crack","Owl Rock",5.8,1,0
1,"West Chimney","Bullwinkle Tower",5.6,1,0
1,Bongeater,"Bongeater Buttress",5.10d,1,0
1,"The Coffin","Coffin Buttress",5.9,1,0
1,"Crescent Crack","Crescent Crack Buttress",5.7,1,0
1,"Route 1","Petes Rock",5.9,1,0
1,"Knifeblade Crack","Petes Rock",5.8,1,0
1,Birdland,"Brass Wall",5.7+,1,0
1,"Ending Crack","Sespe Gorge","5.7, PG13",1,0
1,"Tree Root","Sespe Gorge",5.5,1,0
1,"South Face Left","Point Dume",5.10b,1,0
1,Left,"Point Dume",5.8,1,0
1,"Left Center","Point Dume",5.8,1,0
1,"Sexy Grandma","Hidden Valley Campground",5.9,1,0
1,"Bearded Cabbage","Hidden Valley Campground",5.10c,1,0
1,Buissonier,"Hidden Valley Campground",5.7,1,0
1,"Four Course Meal","Window Dome",5.7,1,0
1,"King of Snake","The Biscuit",5.12a,1,0
1,Swifting,"The Biscuit",5.11a,1,0
1,"Postcards to Pinetop","The Biscuit",5.10a,1,0
1,"Sombreros from Snowflake","The Biscuit",5.10b,1,0
1,"Red Headed Stepchild","The Dump",5.10a,1,0
1,Vermin,"The Dump",5.10b,1,0
1,"Two Bag Face","Fern Buttress","5.9, R",1,0
1,"Triple Treat","Fern Buttress",5.10a,1,0
1,"Shiny Faces","Fern Buttress",5.10d,1,0
1,"Ritz Cracker","Fern Buttress",5.9,1,0
1,"Process of Elimination","DC Memorial Boulder",5.11b,1,0
1,"Two For One","Table Rock","5.9, PG13",1,0
1,"19'-hexanoyloxyfucoxanthin","Whitewater Buttress",5.9,1,0
1,"Prime Rib","Whitewater Buttress",5.10a,1,0
1,"The Devil Wears Prana","The Underworld",5.10b,1,0
1,"Capt Crunch","Cereal Buttress",5.10d,1,0
1,"Born Again","Cereal Buttress",5.10d,1,0
1,"Shredded Wheat","Cereal Buttress",5.11a,1,0
1,"Big Jugs","Sentinel Buttress",5.5,1,0
1,"Bat out of Hell","Pilot Mountain",5.11b,1,0
1,"Cruizin' South","Safe Harbor South",5.5,1,0
1,"Expose'","Safe Harbor South",5.11b,1,0
1,"Autumn Arch","Safe Harbor South",5.10b,1,0
1,"Thin Air","Cathedral Ledge",5.6,1,0
1,"Childs Play","Cathedral Ledge",5.6,1,0
1,Recluse,"Cathedral Ledge",5.11a,1,0
1,"Bird's Nest","Cathedral Ledge",5.9,1,0
1,"Standard Route","Whitehorse Ledge","5.5, R, Grade III",1,0
1,"Rough Rhino","Shagg Crag",5.9,1,0
1,"Fuzzy Rhino Slippers","Shagg Crag",5.11c,1,0
1,"Short Bob","Shagg Crag",5.12a,1,0
1,"The Great Escape","Shagg Crag",5.10b,1,0
1,"Whitney Gilman Ridge","Cannon Cliff","5.7, Grade II",1,0
1,"Charlotte's Crack","Camden Hills",5.7,1,0
1,Guillotine,"Otter Cliffs",5.10a,1,0
1,"Peak Performance","Otter Cliffs",5.10a,1,0
1,"A Dare by the Sea","Otter Cliffs",5.10b,1,0
1,"Easy Corner (aka ? ""Wonder Corner"" )","Otter Cliffs",5.6,1,0
1,Echoes,"Cathedral Ledge","5.11d, PG13",1,0
1,Recompense,"Cathedral Ledge",5.9,1,0
1,"The Prow","Cathedral Ledge",5.11d,1,0
1,"Goofer's Delight","Cathedral Ledge",5.10a,1,0
1,"The Fastest Gun",Poke+AC0-O+AC0-Moonshine,5.10b,1,0
1,"Bloody Mary",Poke+AC0-O+AC0-Moonshine,5.9,1,0
1,"Slim Pickins","The Spiders Web",5.9,1,0
1,Esthesia,"The Spiders Web",5.10a,1,0
1,TR,"The Spiders Web",5.10a,1,0
1,"Good Day","Shelving Rock",5.10b,1,0
1,"The Gong Show","Shelving Rock",5.9,1,0
1,"Grin and Bear It","Shelving Rock",5.8,1,0
1,"Snake Charmer","Shelving Rock",5.9,1,0
1,"Lunar Manscaping","Shelving Rock",5.8,1,0
1,Birdbrain,"The Near Trapps","5.12a, X",1,0
1,"Bird Cage","The Near Trapps",5.10b,1,0
1,"Transcontinental Nailway","The Near Trapps",5.10b,1,0
1,"Ants' Line","The Trapps",5.9,1,0
1,"Space Invaders","The Trapps",5.10d,1,0
1,"Bonnie's Roof","The Trapps",5.9,1,0
1,"High Exposure","The Trapps",5.6,1,0
1,Directissima,"The Trapps",5.9,1,0
1,"Balcony Arête","Great Falls",5.9,1,0
1,Backslider,"Great Falls",5.7,1,0
1,Possibilities,"Great Falls",5.9,1,0
1,"Left Stuff","Great Falls",5.7,1,0
1,"Right Stuff","Great Falls",5.7,1,0
1,"Madmen Only","Seneca Rocks",5.10a,1,0
1,Gebhardt-Dufty,"Seneca Rocks",5.7,1,0
1,"Marshall's Madness - Crack of Dawn","Seneca Rocks",5.10a,1,0
1,"The Daddy","Linville Amphitheater",5.6,1,0
1,"White Lightning","Table Rock",5.8-,1,0
1,"Exploratory 5.5","Whitewater Buttress",5.5,1,0
1,"Raise Hell","Moores Amphitheater",5.8-,1,0
1,Nutsweat,"Moores North End",5.9+,1,0
1,Nevermore,"Moores North End",5.9-,1,0
1,"Break On Through","Circus Wall",5.10a,1,0
1,"Skatin'","Pilot Mountain",5.11d,1,0
1,"Air Show","Circus Wall",5.9-,1,0
1,Scabies,"Pebble Beach",5.9+,1,0
1,Brontosaurus,"Pebble Beach",5.10b,1,0
1,"Environmental Impact","Pebble Beach",5.7+,1,0
1,"Souders Crack","Long Wall","5.1, R",1,0
1,Mailbox,"Long Wall",5.8+,1,0
1,Yuk,"Long Wall","5.9, PG13",1,0
1,Autumn,"Long Wall",5.9,1,0
1,"Rock Wars","Long Wall",5.10a,1,0
1,"Super Best Friends","The Solarium",5.12a,1,0
1,"Stay Off the Radio Jeff!","Bruise Brothers Wall",5.9+,1,0
1,"The Bee's Business","Bruise Brothers Wall",5.8-,1,0
1,"Air Ride Equipped","The Solarium",5.11a,1,0
1,"Caver's Route","Tower Rock","5.3, R",1,0
1,"Rainy Day Women","Stone Mountain","5.10a, R",1,0
1,Yardarm,"Stone Mountain","5.8, PG13",1,0
1,"Skin Toy",Sauratown,5.11d,1,0
1,"Green Arrow",Sauratown,5.10a,1,0
1,"DC Comics",Sauratown,5.10b,1,0
1,"Deadbeat Dad",Sauratown,5.11d,1,0
1,"Pilot's License",Sauratown,5.10b,1,0
1,"I'll Be Danned",Sauratown,5.10d,1,0
1,"5.7 Corner",Sauratown,5.7+,1,0
1,"Anchors Away","Pilot Mountain",5.11d,1,0
1,Unknown,"Pilot Mountain",5.8,1,0
1,"The Pulpit","Stone Mountain",5.8,1,0
1,"Boyz N Berries","The Dump",5.11a,1,0
1,"Grace Under Pressure","The Cookbook",5.10b,1,0
1,"The Dish","Crowders Mountain",5.9,1,0
1,"Ooga Chocka","Crowders Mountain",5.8,1,0
1,Electra,"Crowders Mountain",5.10c,1,0
1,Caterpillar,"Rocky Face",5.7+,1,0
1,"The Twins Right","Rocky Face",5.9+,1,0
1,"Mr. Aidman's Free","Rocky Face",5.11a,1,0
1,"Crimps and Slopers","Rocky Face",5.10b,1,0
1,"Lust in a Cheap Motel",Sauratown,5.10b,1,0
1,"Double Roof Ballet","Rocky Face",5.11c,1,0
1,Boardwalk,"Ship Rock",5.8,1,0
1,Harpoon,"Ship Rock",5.10a,1,0
1,Scarface,"Pilot Mountain",5.6,1,0
1,"Pee Break","Pilot Mountain",5.6,1,0
1,"Rod Serling Crack","Beauty Mountain",5.10b,1,0
1,"Quick Robin, to the Batcrack!","Beauty Mountain",5.10a,1,0
1,"Baby Has a Bolt Gun","Orange Oswald Wall",5.10c,1,0
1,"Sand in My Crack (Cuddle Monkey)","Rico Suave Buttress",5.7,1,0
1,"Second Thoughts","Rico Suave Buttress",5.9+,1,0
1,"Born to Crimp","Pilot Mountain",5.10b,1,0
1,"Turkey Shoot","Pilot Mountain",5.8,1,0
1,Hopscotch,"Moores Central Wall",5.3,1,0
1,"Hidden in Plain Sight","Pilot Mountain",5.11a,1,0
1,"Orange Peel","Pilot Mountain",5.9+,1,0
1,"Venus Scribner","Pilot Mountain",5.10b,1,0
1,"Buzzard's Breath","Pilot Mountain",5.8,1,0
1,Banana,"Seneca Rocks",5.7,1,0
1,Debbie,"Seneca Rocks",5.6,1,0
1,Englevinger,Svolvaergeita,5.10c,1,0
1,"Bare Blabaer",Djupfjorden,"5.8, Grade II",1,0
1,"There Is To Do",Djupfjorden,5.10a,1,0
1,"Tromso ekspressen","Gandalf Wall",5.10a,1,0
1,"The Boys First Journey at Sea","Gandalf Wall",5.11a,1,0
1,"Gamle rev","Gandalf Wall",5.10a,1,0
1,"Guns N' Roses","Gandalf Wall",5.10c,1,0
1,Gollum,"Gandalf Wall",5.8+,1,0
1,"Vestpillaren Direct",Presten,"5.10d, Grade III",1,0
1,"Standard Route",Galdhopiggen,"Easy Snow, Grade III",1,0
1,"Oye for Oye",Natten,5.7,1,0
1,"Jimi Embrik",Natten,5.10d,1,0
1,Skyggediederet,Natten,5.8,1,0
1,Solstikk,Natten,5.8,1,0
1,"Bakom Synger Skogene",Natten,5.8,1,0
1,Hoppalong,Natten,5.10b,1,0
1,Hallingmarsjen,Nesbyen,5.8,1,0
1,Helgepraten,Nesbyen,5.10b,1,0
1,"Fissura Hulk","Fendas de Barrinha",5.8,1,0
1,Thanos,"Fendas de Barrinha",5.9+,1,0
1,Despacito,"Fendas de Barrinha",5.4,1,0
1,"Chamine Stop","Pao de Acucar","5.7+, R, Grade III",1,0
1,"Diedro Pegasus",Babilonia,5.8,1,0
1,"Bom Dia Africa","Plato de Lagoa",5.12a,1,0
1,"Crystal Cannibal","Plato de Lagoa",5.9,1,0
1,"Mico Mija",Graalzinho,5.11b,1,0
1,"Vilma Arnaud",Babilonia,5.6,1,0
1,"Mauricio Mota",Babilonia,5.5,1,0
1,Loki,Aquidauana,5.10a,1,0
1,R2D2,Aquidauana,5.11a,1,0
1,ResPira,Aquidauana,5.10a,1,0
1,"Mata Burro",Aquidauana,5.9+,1,0
1,Aerophobia,"Pilot Mountain",5.6,1,0
1,"Over Booked","Pilot Mountain",5.7,1,0
1,"Pontius Pilot","Pilot Mountain",5.10a,1,0
1,Hurly-Burly,"Pilot Mountain",5.9,1,0
1,"Wrestling with the Textonic","Pilot Mountain",5.9,1,0
1,"Play It Again","Pilot Mountain",5.10a,1,0
1,"Skull & Bones","Pilot Mountain",5.8,1,0
1,"Ramp Arete","Big Rock Mountain",5.7,1,0
1,"5.9 Offwidth","Big Rock Mountain",5.9,1,0
1,Flakey,"Big Rock Mountain",5.8,1,0
1,"S Crack","Big Rock Mountain",5.10a,1,0
1,"Shock the Monkey",Sauratown,5.10c,1,0
1,"Old Man's Sport Route",Sauratown,5.11a,1,0
1,Bernalina,"Pena de Bernal","5.7, Grade II",1,0
1,"That Eight (aka Kennel Club)","Sand Rock",5.8,1,0
1,"Northeast Buttress","Mt. Goode",5.5,1,0
1,"Junior's Farm","Tyler Peak Crags","5.8, PG13, Grade III",1,0
1,"Groover (Gaskin Finish)","Laurel Knob",5.8+,1,0
1,"Unknown 5.9","Hartman Rocks",5.9,1,0
1,"The Maiden Voyage aka The Red Dihedral","Black Canyon of the Gunnison","5.9-, Grade III",1,0
1,"King Me","Black Canyon of the Gunnison","5.10a, Grade II",1,0
1,"Dunn's Dihedral","Taylor Canyon",5.8,1,0
1,"Buddha's Belly","Hartman Rocks",5.10a,1,0
1,"The Worm Hole","Hartman Rocks",5.7,1,0
1,"Rising Expectations","Hartman Rocks",5.1,1,0
1,"Shovel Head","Spring Creek",5.9,1,0
1,"Poker in the Rear","Spring Creek",5.9,1,0
1,"13 Bolt (Ride Hard, Die Free)","Spring Creek",5.10a,1,0
1,"South Face","South Sixshooter",5.7,1,0
1,"North Ridge","The Sphinx",5.7,1,0
1,Terma,Utopia,"5.9, PG13",1,0
1,"Standard Route (West Fins)","Elephant Butte",5.3,1,0
1,"Regular Route (""East Rib"")","Looking Glass Rock","5.4, PG13",1,0
1,"Mountaineers Route","Parriot Mesa","5.6, Grade II",1,0
1,Duracell,"Pilot Mountain",5.8,1,0
1,"Howdy Dude","Pilot Mountain",5.7,1,0
1,"Super Pinch","Gold Coast",5.10d,1,0
1,"Sunny the Boxer","Gold Coast",5.9,1,0
1,"Norway On My Mind","Gold Coast",5.9,1,0
1,"Get Outta My Way","Fortress Wall","5.2, R",1,0
1,"Gettin' Lucky in Kentucky","Tectonic Wall",5.10b,1,0
1,"Plate Tectonics","Tectonic Wall",5.10a,1,0
1,"59"" DrillBitch","Johnnys Wall",5.10a,1,0
1,"Left Wishbone (Rock Scramble)","Black Mountain Alpine",5th,1,0
1,"737 Max","Pilot Mountain",5.8,1,0
1,"The Nose","Looking Glass Rock",5.8,1,0
1,"Lucy in the Sky with Diamonds","Mount Yonah",5.10a,1,0
1,"Edges to Ledges","Mount Yonah",5.7,1,0
1,"Ohio Climbing","Bruise Brothers Wall",5.8,1,0
1,"Glory and Consequence","The Great Wall",5.7+,1,0
1,Misty,"Sand Rock",5.10c,1,0
1,"Neckerchief? Traverse","Sand Rock",5.6,1,0
1,Neckerchief?,"Sand Rock","5.8, PG13",1,0
1,"Laurel Springs WI4","Laurel Springs Ice",WI4-,1,0
1,"Cave Route","Table Rock",5.5,1,0
1,"Cave Routes  1 and  2","The Junkyard",5.7,1,0
1,"Jeff's Bunny Hop","Narcissus Cave",5.8,1,0
1,"Orange Express","Orange Oswald Wall",5.10b,1,0
1,"Orange Oswald","Orange Oswald Wall",5.10a,1,0
1,Trundlerama,"Tieranny Roofs",5.11a,1,0
1,"Dutch Boy","Tieranny Roofs",5.10b,1,0
1,"Rover B. Dog","Tieranny Roofs",5.10a,1,0
1,Incredarete,"Stone Fort",V0-,1,0
1,"Two Can Sam","Stone Fort",V2-,1,0
1,"Needless Things","Stone Fort",V0-,1,0
1,"Fire Crack Flake","Stone Fort",V0-,1,0
1,Dice,"Stone Fort",V1-,1,0
1,"Costume Rings","Stone Fort",V0-,1,0
1,"Whisky For Breakfast","Cereal Buttress","5.10d, PG13",1,0
1,"Wild Seed","Fern Buttress",5.11a,1,0
1,Crescenta,"Fern Buttress",5.10a,1,0
1,Hysteria,"Fern Buttress",5.8,1,0
1,"Anal Clenching Adventures","Fern Buttress",5.10a,1,0
1,Remission,"Endless Wall",5.10b,1,0
1,"Can I Do It Till I Need Glasses","Endless Wall",5.10c,1,0
1,"The Grafenburg Crack","Endless Wall",5.9-,1,0
1,"The Undeserved","Endless Wall",5.10b,1,0
1,"Celibate Mallard","Endless Wall",5.10c,1,0
1,"Black and Tan","Endless Wall",5.10a,1,0
1,"Doce Doe","Endless Wall",5.8,1,0
1,Fantasy,"Endless Wall",5.8,1,0
1,"Big Alternative","The Junkyard",V3-,1,0
1,"Warm-up Roof","The Junkyard",V1-,1,0
1,"Reachers of Habit","The Junkyard",5.11b,1,0
1,"Jumpin' Jack Flash","The Junkyard",5.7+,1,0
1,Realignment,"The Junkyard",5.10d,1,0
1,"Stretch Armstrong","Bridge Buttress",5.12a,1,0
1,Jaws,"Bridge Buttress",5.9+,1,0
1,"Brain Tweezers","Beauty Mountain",5.10c,1,0
1,"Brain Storm","Beauty Mountain",5.8,1,0
1,"You Want It, You Got It","Beauty Mountain",5.9,1,0
1,"Going Ballistic","Long Wall",5.10d,1,0
1,"Flight Path","Long Wall",5.10b,1,0
1,"That Eight","Narcissus Cave",5.8-,1,0
1,"Rapscallion's Blues","The Junkyard",5.10c,1,0
1,"The Distortionist","The Junkyard",5.6,1,0
1,"Fred Sandstone Flake","Bubba City",5.9,1,0
1,Werewolf,"Bubba City","5.10a, PG13",1,0
1,"My Sister Makes Cluster Bombs","Bubba City",5.11c,1,0
1,"Daisy Cutter","Bubba City",5.7,1,0
1,"Eight Ball in the Side Pocket","Bubba City",5.12a,1,0
1,"Basic Bubba Crack","Bubba City",5.9,1,0
1,"Flatten your Curves","Teer Quarry",5.7,1,0
1,Benadryl,"Grayson Highlands",V0,1,0
1,"Bumble Bee","Grayson Highlands",V0,1,0
1,Honeycomb,"Grayson Highlands",V0,1,0
1,"Eye of the Narwhal","Grayson Highlands",V3-,1,0
1,Colony,"Grayson Highlands",V1-,1,0
1,"The Hive","Grayson Highlands",V2-,1,0
1,"Sunset Arete","Grayson Highlands",V0-,1,0
1,"All Things Considered","Grayson Highlands",V2-,1,0
1,"Highlands Lowball (corner version) Arete","Grayson Highlands",V2,1,0
1,"My Route","Table Rock",5.6,1,0
1,"North Ridge","Table Rock",5.5,1,0
1,"Tight Rope","The Trestle",5.8,1,0
1,"All Gold Everything","The Trestle",5.9,1,0
1,Redacted,"The Trestle",5.10a,1,0
1,"White Trash","The Dump",5.10a,1,0
1,"I Gotta Wear Shades","Pilot Mountain",5.9,1,0
1,"The Humbler","The Chimneys",5.6,1,0
1,"The Tumbler","The Chimneys",5.6,1,0
1,"Mama Bear","Pilot Mountain",5.10b,1,0
1,"Mercury's Lead","Stone Mountain","5.9, R",1,0
1,"Bombay Groove aka Yankee Go Home","Stone Mountain","5.10a, PG13",1,0
1,Washboard,"Moores Central Wall",5.6,1,0
1,"Blue Chock","Moores Central Wall",5.10b,1,0
1,"Nuclear Crayon","Moores Amphitheater","5.10d, PG13",1,0
1,"Do or Dive","Moores Amphitheater",5.10a,1,0
1,"Alcoa Presents","Seneca Rocks",5.8,1,0
1,"Conn's East Direct","Seneca Rocks",5.8,1,0
1,"The Warlock","Seneca Rocks",5.9+,1,0
1,Discrepancy,"Seneca Rocks",5.8,1,0
1,"Blind Prophet Lite","Pilot Mountain","5.11b, PG13",1,0
1,"Place Your Bet","Pilot Mountain",5.7,1,0
1,Goldilocks,"Pilot Mountain",5.5,1,0
1,"Pump Street","Pilot Mountain",5.10a,1,0
1,Eurozone,"Pilot Mountain",5.10a,1,0
1,"The Kessel Run","Moores Wall Bouldering",V2-,1,0
1,"Boone Lounge","Moores Wall Bouldering",V2-,1,0
1,"What's In A Name","Moores Wall Bouldering",V2-,1,0
1,"Admiral Aretebar","Moores Wall Bouldering",V1-,1,0
1,V3PO,"Moores Wall Bouldering",V2-,1,0
1,"The Taoist","Moores Wall Bouldering",V0-,1,0
1,Oh-V1-Kenobi,"Moores Wall Bouldering",V0-,1,0
1,"It's A Trap","Moores Wall Bouldering",V1,1,0
1,"Gentle Ben","Pilot Mountain",5.10a,1,0
